#####################
#A  #     #     #   #
# # # ### # ### # # #
# # #   # # #   # # #
# # ### # # # ### # #
# # # # # # #   # # #
# # # # # # ### # # #
# # #   # #   # # # #
# ##### # ### # # # #
#     # #   #   #   #
### # # # # ##### ###
#   # # # #         #
# ### # # ######### #
#   #   #         #B#
#####################
